a		
a		b
awkward		(adj) vụng về, lung túng
awful		(adj) oai nghiêm, dễ sợ
away		(adv) xa, xa cách, rời xa, đi xa
aware		(adj) biết, nhận thức, nhận thức thấy
award		(n) (v) phần thưởng; tặng, thưởng
awake		(adj) đánh thức, làm thức dậy
avoid		(v) tránh, tránh xa
average		adj., (n) trung bình, số trung bình, mức trung bình
available		(adj) có thể dùng được, có giá trị, hiệu lực
autumn		(n) mùa thu (US: mùa thu là fall)
automatic		(adj) tự động
aunt		(n) cô, dì
audience		(n) thính, khan giả
attractive		(adj) hút, thu hút, có duyên, lôi cuốn
attraction		(n) sự hút, sức hút
attract		(v) hút; thu hút, hấp dẫn
attorney		(n) người được ủy quyền
attitude		(n) thái độ, quan điểm
attention		(n) sự chú ý
attend		(v) dự, có mặt
attempt		(n) (v) sự cố gắng, sự thử; cố gắng, thử
attach		(v) gắn, dán, trói, buộc
atom		(n) nguyên tử
atmosphere		(n) khí quyển
at least		ít ra, ít nhất, chí ít
at first		trực tiếp
assure		(v) đảm bảo, cam đoan
assume		(v) mang, khoác, có, lấy (cái vẻ, tính chất…)
associate		(v) kết giao, liên kết, kết hợp, cho cộng tác
assistant		(n) (adj) người giúp đỡ, người phụ tá; giúp đỡ
assistance		(n) sự giúp đỡ
assist		(v) giúp, giúp đỡ; tham dự, có mặt
aspect		(n) vẻ bề ngoài, diện mạo
asleep		(adj) ngủ, đang ngủ
aside		(adv) về một bên, sang một bên
ashamed		(adj) ngượng, xấu hổ
as well as		cũng, cũng như
as soon as		ngay khi
as		(prep,adv, conj.) như
artistic		(adj) thuộc nghệ thuật, thuộc mỹ thuật
artist		(n) nghệ sĩ
artificial		(adj) nhân tạo
article		(n) bài báo, đề mục
art		(n) nghệ thuật, mỹ thuật
arrow		(n) tên, mũi tên
arrive		(+at, in) (v) đến, tới nơi
arrival		(n) sự đến, sự tới nơi
arrest		(v) (n) bắt giữ, sự bắt giữ
arrangement		(n) sự sắp xếp, sắp đặt, sự sửa soạn
arrange		(v) sắp xếp, sắp đặt, sửa soạn
around		(adv, prep.)xung quanh, vòng quanh
army		(n) quân đội
arm		(n) (v) cánh tay; vũ trang, trang bị (vũ khí)
arise		(v) xuất hiện, nảy ra, nảy sinh ra
argument		(n) lý lẽ
argue		(v) tranh luận
area		(n) diện tích, bề mặt
approximate		(+to) (adj) giống với, giống hệt với
approve		(v) tán thành, đồng ý, chấp thuận
angry		(adj) giận, tức giận
and		(conj) và
ancient		(adj) xưa, cổ
analysis		(n) sự phân tích
amuse		(v) làm cho vui, thích, làm buồn cười,thích thú
amount		(n) (v) số lượng, số nhiều; lên tới (money)
among		(prep) giữa, ở giữa
ambulance		(n) xe cứu thương, xe cấp cứu
ambition		(n) hoài bão, khát vọng
amaze		(v) làm ngạc nhiên, làm sửng sốt
always		(adv) luôn luôn
altogether		(adv) hoàn toàn, hầu như; nói chung
alternative		(n) (adj) sự lựa chọn; lựa chọn
alter		(v) thay đổi, biến đổi, sửa đổi
also		(adv) cũng, cũng vậy, cũng thế
already		(adv) đã, rồi, đã… rồi
aloud		(adv) lớn tiếng, to tiếng
alongside		(prep) (adv) sát cạnh, kế bên, dọc theo
alone		(adj) (adv) cô đơn, một mình
all		(n) (adv) tất cả
alive		(adj) sống, vẫn còn sống, còn tồn tại
alcohol		(n) rừợu cồn
alarm		(n) (v) báo động, báo nguy
aircraft		(n) máy bay, tàu bay, khí cầu
air		(n) không khí, bầu không khí, không gian
aim		(n) (v) sự nhắm (bắn), mục tiêu, ý định; nhắm, tập trung, hướng vào
ahead		(adv) trước, về phía trước
ago		(adv) trước đây
aggressive		(adj) xâm lược, hung hăng (US: xông xáo)
agent		(n) đại lý, tác nhân
agency		(n) tác dụng, lực; môi giới, trung gian
age		(n) tuổi
afterwards		(adv) sau này, về sau, rồi thì, sau đấy
afternoon		(n) buổi chiều
after		(prep) (conj) sau, đằng sau, sau khi
afraid		(adj) sợ, sợ hãi, hoảng sợ
afford		(v) có thể, có đủ khả năng, điều kiện (làm gì)
affection		(n) tình cảm, cảm xúc
affect		(v) làm ảnh hưởng, tác động đến
affair		(n) việc
advise		(v) khuyên, khuyên bảo, răn bảo
advice		(n) lời khuyên, lời chỉ bảo
advertisement		(n) quảng cáo
advertise		(v) báo cho biết, báo cho biết trước
adventure		(n) sự phiêu lưu, mạo hiểm
advantage		(n) sự thuận lợi, lợi ích, lợi thế
advance		(n) (v) sự tiến bộ, tiến lên; đưa lên, đề xuất
adult		(n) (adj) người lớn, người trưởng thành;
adopt		(v) nhận làm con nuôi, bố mẹ nuôi
admit		(v) nhận vào, cho vào, kết hợp
admire		(v) khâm phục, thán phục
admiration		(n) sự khâm phục,người khâm phục, thán phục
adjust		(v) sửa lại cho đúng, điều chỉnh
adequate		(adj) đầy, đầy đủ
address		(n) (v) địa chỉ, đề địa chỉ
additional		(adj) thêm vào, tăng thêm
add		(v) cộng, thêm vào
adapt		(v) tra, lắp vào
actually		(adv) hiện nay, hiện tại
actual		(adj) thực tế, có thật
actress		(n) diễn viên nữ
actor		(n) diễn viên nam
activity		(n) sự tích cực, sự hoạt động, sự hăng hái
across		(adv) (prep) qua, ngang qua
acquire		(v) dành được, đạt được, kiếm được
acknowledge		(v) công nhận, thừa nhận
acid		(n) axit
accuse		(v) tố cáo, buộc tội, kết tội
accurate		(adj) đúng đắn, chính xác, xác đáng
account		(n) (v) tài khoản, kế toán; tính toán
accompany		(v) đi theo, đi cùng, kèm theo
accommodation		(n) sự thích nghi, điều tiết
accidentally		(adv) tình cờ, ngẫu nhiên
accidental		(adj) tình cờ, bất ngờ
accident		(n) tai nạn, rủi ro
access		(n) lối, cửa, đường vào
acceptable		(adj) có thể chấp nhận, chấp thuận
accept		(v) chấp nhận, chấp thuận
accent		(n) trọng âm, dấu trọng âm
academic		(adj) thuộc học viện, ĐH, viện hàn lâm
abuse		(n) (v) lộng hành, lạm dụng
absorb		(v) thu hút, hấp thu, lôi cuốn
absolutely		(adv) tuyệt đối, hoàn toàn
absolute		(adj) tuyệt đối, hoàn toàn
absent		(adj) vắng mặt, nghỉ
absence		(n) sự vắng mặt
abroad		(adv) ở, ra nước ngoài, ngoài trời
above		(adv) ở trên
about		(adv) (prep) khoảng, về
able		(adj) có năng lực, có tài
ability		(n) khả năng, năng lực
abandon		(v) bỏ, từ bỏ
a little		nhỏ, một ít
a few		một ít, một vài
tyre		(n) lốp, vỏ xe
typically		(adv) điển hình, tiêu biểu
typical		(adj) tiêu biểu, điển hình, đặc trưng
type		(n) (v) loại, kiểu, mẫu; phân loại, xếp loại
twisted		(adj) được xoắn, được cuộn
twist		(v) (n) xoắn, cuộn, quắn; sự xoắn, vòng xoắn
twin		(n) (adj) sinh đôi, tạo thành cặp; cặp song sinh
twice		(adv) hai lần
turn		(v) (n) quay, xoay, vặn; sự quay, vòng quay
tunnel		(n) đường hầm, hang
tune		(n) (v) điệu, giai điệu; lên dây, so dây (đàn)
tuesday		thứ 3
tube		(n) ống, tuýp
try		(v) thử, cố gắng
truth		(n) sự thật
trust		(n) (v) niềm tin, sự phó thác; tin, tin cậy, phó thác
truly		(adv) đúng sự thật, đích thực, thực sự
true		(adj) đúng, thật
truck		(n) rau quả tươi
trousers		(n) quần
trouble		(n) điều lo lắng, điều muộn phiền
tropical		(adj) nhiệt đới
trip		(n) (v) cuộc dạo chơi, cuộc du ngoạn; đi dạo, du ngoạn
trick		(n) (v) mưu mẹo, thủ đoạn, trò lừa gạt; lừa, lừa gạt
triangle		(n) hình tam giác
trial		(n) sự thử nghiệm, cuộc thử nghiệm
trend		(n) phương hướng, xu hướng, chiều hướng
treatment		(n) sự đối xử, sự đối đãi, sự cư xử (với người nào)
treat		(v) đối xử, đối đãi, cư xử
traveller		(n) người đi, lữ khách
travel		(v) (n) đi lại, đi du lịch, di chuyển; sự đi, những chuyến đi
trap		(n) (v) đồ đạc, hành lý; bẫy, cạm bãy; bẫy, giữ, chặn lạ
transport		(v) (n) sự vận chuyển, sự vận tải;chuyên chở, phương tiện đi lại
transparent		(adj) trong suốt; dễ hiểu, sáng sủa
translation		(n) sự dịch
translate		(v) dịch, biên dịch, phiên dịch
transform		(v) thay đổi, biến đổi
transfer		(v) (n) dời, di chuyển; sự di chuyển, sự dời chỗ
training		(n) sự dạy dỗ, sự huấn luyện, sự đào tạo
train		(n) (v) xe lửa, tàu hỏa; dạy, rèn luyện, đào tạo
traffic		(n) sự đi lại, sự giao thông, sự chuyển động
traditionally		(adv) (thuộc) truyền thống, là truyền thống
traditional		(adj) theo truyền thống, theo lối cổ
tradition		(n) truyền thống
trading		(n) sự kinh doanh, việc mua bán
trade		(n) (v) thương mại, buôn bán; buôn bán, trao đổi
track		(n) phần của đĩa; đường mòn, đường đua
trace		(v) (n) phát hiện, tìm thấy, vạch, chỉ ra, phác họa; dấu, vết
toy		(n) (adj) đồ chơi, đồ trang trí; thể loại đồ chơi
town		(n) thị trấn, thị xã, thành phố nhỏ
tower		(n) tháp
towel		(n) khăn tắm, khăn lau
towards		(prep) theo hướng, về hướng
tourist		(n) khách du lịch
tour		(n) (v) cuộc đi du lịch, cuộc đi dạo, chuyến du lịch; đi du lịch
tough		(adj) chắc, bền, dai
touch		(v) (n) sờ, mó, tiếp xúc; sự sờ, sự mó, sự tiếp xúc
totally		(adv) hoàn toàn
total		(adj) (n) tổng cộng, toàn bộ; tổng số, toàn bộ số lượng
topic		(n) đề tài, chủ đề
top		(n) (adj) chóp, đỉnh; đứng đầu, trên hết
tooth		(n) răng
tool		(n) dụng cụ, đồ dùng
tonne		(n) tấn
tongue		(n) lưỡi
tone		(n) tiếng, giọng
ton		(n) tấn
tomorrow		(adv) (n) vào ngày mai; ngày mai
tomato		(n) cà chua
toilet		(n) nhà vệ sinh; sự trang điểm (rửa mặt, ăn mặc, chải tóc...)
together		(adv) cùng nhau, cùng với
toe		(n) ngón chân (người)
title		(n) đầu đề, tiêu đề; tước vị, tư cách
tiring		(adj) sự mệt mỏi, sự mệt nhọc
tired		(adj) mệt, muốn ngủ, nhàm chán
tire		(v) (n) làm mệt mỏi, trở nên mệt nhọc; lốp, vỏ xe
tip		(n) (v) đầu, mút, đỉnh, chóp; bịt đầu, lắp đầu vào
tiny		(adj) rất nhỏ, nhỏ xíu
tin		(n) thiếc
timetable		(n) kế hoạch làm việc, thời gian biểu
time		(n) thời gian, thì giờ
till		cho đến khi, tới lúc mà
tightly		(adv) chặc chẽ, sít sao
tight		(adj) (adv) kín, chặt, chật
tie sth up		có quan hệ mật thiết, gắn chặt
tie		(v) (n) buộc, cột, trói; dây buộc, dây trói, dây giày
tidy		(adj) (v) sạch sẽ, ngăn nắp, gọn gàng
ticket		(n) vé
thus		(adv) như vậy, như thế, do đó
thumb		(n) ngón tay cái
throw sth away		ném đi, vứt đi, liệng đi
throw		(v) ném, vứt, quăng
throughout		(adv) khắp nơi, từ đầu đến cuối, suốt
through		(adv) qua, xuyên qua
throat		(n) cổ, cổ họng
threatening		(adj) sự đe dọa, sự hăm dọa
threaten		(v) dọa, đe dọa
threat		(n) sự đe dọa, lời đe dọa
thread		(n) chỉ, sợi chỉ, sợi dây
thought		(n) sự suy nghĩ, khả năng suy nghĩ; ý nghĩ, tư tưởng, tư duy
though		(adv) dù, dù cho, mặc dù; mặc dù, tuy nhiên, tuy vậy
thoroughly		(adv) kỹ lưỡng, thấu đáo, triệt để
thorough		(adj) cẩn thận, kỹ lưỡng
this		pro(n) cái này, điều này, việc này
thirsty		(adj) khát, cảm thấy khát
thinking		(n) sự suy nghĩ, ý nghĩ
think		(v) nghĩ, suy nghĩ
thing		(n) cái, đồ, vật
thin		(adj) mỏng, mảnh
thief		(n) kẻ trộm, kẻ cắp
thickness		(n) tính chất dày, độ dày, bề dày
thickly		(adv) dày; dày đặc; thành lớp dày
thick		(adj) dày; đậm
therefore		(adv) bởi vậy, cho nên, vì thế
there		(adv) ở nơi đó, tại nơi đó
theory		(n) lý thuyết, học thuyết
then		(adv) khi đó, lúc đó, tiếp đó
themselves		pro(n) tự chúng, tự họ, tự
theme		(n) đề tài, chủ đề
theatre		(n) rạp hát, nhà hát
the rest		vật, cái còn lại, những người, cái khác
the		cái, con, người, ấy này, duy nhất
that		pro(n) (conj) người ấy, đó, vật ấy, đó; rằng, là
thanks		(n) sự cảm ơn, lời cảm ơn
thank		(v) cám ơn
than		(conj) hơn
text		(n) nguyên văn, bản văn, chủ đề, đề tài
test		(n) (v) bài kiểm tra, sự thử nghiệm, xét nghiệm; kiểm tra
terribly		(adv) tồi tệ, không chịu nổi
terrible		(adj) khủng khiếp, ghê sợ
term		(n) giới hạn, kỳ hạn, khóa, kỳ học
tent		(n) lều, rạp
tension		(n) sự căng, độ căng, tình trạng căng
tendency		(n) xu hướng, chiều hướng, khuynh hướng
tend		(v) trông nom, chăm sóc, giữ gìn, hầu hạ
temporary		(n) tạm thời, nhất thời, lâm thời
temporarily		(adv) tính chất tạm thời, nhất thời
temperature		(n) nhiệt độ
tell		(v) nói, nói với
television		(n) vô tuyến truyền hình
telephone		(n) (v) máy điện thoại, gọi điện thoại
technology		(n) kỹ thuật học, công nghệ học
technique		(n) kỹ sảo, kỹ thuật, phương pháp kỹ thuật
technical		(adj) (thuộc) kỹ thuật, chuyên môn
tear		(v) (n) xé, làm rắch; chỗ rách, miếng xe; nước mắt
team		(n) đội, nhóm
teaching		(n) sự dạy, công việc dạy học
teacher		(n) giáo viên
teach		(v) dạy
tea		(n) cây chè, trà, chè
tax		(n) (v) thuế; đánh thuế
taste		(n) (v) vị, vị giác; nếm
task		(n) nhiệm vụ, nghĩa vụ, bài tập, công tác, công việc
target		(n) bia, mục tiêu, đích
tape		(n) băng, băng ghi âm; dải, dây
tap		(v) (n) mở vòi, đóng vồi; vòi, khóa
tank		(n) thùng, két, bể
talk		(v) (n) nói chuyện, trò chuyện; cuộc trò chuyện, cuộc thảo luận
take sth over		chở, chuyển cái gì; tiếp quản, kế tục cái gì
take sth off		cởi, bỏ cái gì, lấy đi cái gì
take place		xảy ra, được cử hành, được tổ chức
take part in		tham gia vào
take notice of		chú ý
take		(v) sự cầm nắm, sự lấy
tail		(n) đuôi, đoạn cuối
tackle		(v) (n) giải quyết, khắc phục, bàn thảo; đồ dùng,dụng cụ
tablet		(n) tấm, bản, thẻ phiến
table		(n) cái bàn
with		(prep) với, cùng
hello		xin chao
hello		Chao cc
a few		it cc
hello, world!		xin chào, tôi là lập trình viên!
delete		(v) xóa
helpful		(adj) có ích; giúp đỡ
hello		(v) xin chào
